Tilemapping Version 1.0
#tileset
tileset1.bmp
8 1
tile0: vide
tile1: plein
tile2: plein
tile3: plein
tile4: plein
tile5: plein
tile6: plein
tile7: plein
#level
30 13

000000000000000000000000000000
000000000000000000000000000000
000000000000000000000000000000
000000000000000000000000000000
000000000555666000000000000000
000000000000000000000560000000
000000000000000000000000000000
001000000000000000000000002222
222200000000000000000000002222
222200000000770000077700002222
222200000000770000070000002222
222200000000770000070000002222
777777777777777777777777777777

#fin